.#.##.##..#....#......#..####.##.##.##.#...#.#.......#.##..##.....#.######.#.#..#.#.#..##.##...#...##.##.
..#.######.###.##..#####.##.#..#.#....###.##.####..#.##.#.#.######...##...##.##.##..##..######.##.#.####.
#..#..##.##..#.####.........##...#..#.###.##...#####..###......#.#......#.##..##.#...#.#..#..#.##..#..#..
##.....#..#.##.#..#..###.######..###.........#.#.........##..#.#.##..##.#........##.##.#..#.##..##....##.
#.##...####.##.#.####..#.#..#.####.#..###.####.##.##.###.#####.########.#.##.######.##.####.###.#.##.#.##
#..##.#..#....##....#.##..#.###..#.####.#.#...#.#..#.###.#....#......#..####.##...#...#..##..#..#..#..#..
##.##....##.#.#######.###..#...#.#.#...##...#...##....##.#..#..####..#.#.......##.#.#........#..##..#....
##.####.#.#.#..##..##..#.#.#.#..##..##.#.##..########...###..#.##.#..#...#####.#..#####..##############..
##...##..##.#....#.....##..#..#.###.#..#####.#..#.....#.#.##......##..####.....#....#####....#..#....####
...#..##.#..#..#...###..#.###.#..#..##...###....#..##.#.######.######......##.###.......#..#.##.#..#.....
#####....#.####.###..####.#.#.#..#...##...#.##.####.#.##..##.###..#.###.#####.####.#########..#########.#
#..#.##..#.##.#...#.#..##.##..#####.#.###.####..#.##....#...#..#..###.#....#.....#.##..#........#..##.#..
#..##.###....######..#..##.#.....##......#..#.#.##.#.##...#....###....##...#..##.....#.##.##.##.#.....##.
#.#.###.####.##....#.....#.##..#.####..#.##.##....##.#.##.###.#...########.#######.#..#.#..#.#..#.#######
#..#............###.##.#.#.####...######..##.#..#....##.#..##..##.##..#..#.#..##.#..#...##...#..#.##..#.#
.#.#.##..##.#####.#..#..##....#.....#........###.####.##.#..##.#...#..#.##..#...###.########.###...#..##.
##.#.####.#..#...###..#.####.###.##.#.##.###.#.###..##.####.#..#.#.####.###...#.###..#..#..###.#...###.##
..##..#.##.#.###.#####...###...#.#..#..#.###.#........#..#..##.#..#......#.##.#..#.#....#.#..#.##.#......
#.#.#.##.###......##.#....####...#..###...##.##.##..#....#...#..#..####..##.#.#..##.##.##..#.#.##..####..
#.##...##....####...#####..####..####.##....#.#..###.######.######.##.###.##..##..####..##..##.###.##.###
##.#....#.###.....#.##..#...#.####.....##.#...####.###...##.#........#..##.#...#.#..#.#...#.##..#........
.#.##...###.#..##.#.....#...###..####.#.#######..#.....#....#..#####.......##.##.##.##.##.......#####..#.
.#.###.....####.#.#.##.#####...#...##..#..##...#.##.###.##.####.....##.######.##..##.######.##.....####.#
##...##..#..#.##..##.#.##..###...#..##.....#.#..#.##..####..#.#..##..#.##..............##.#..##..#.#..###
###########.##.#...#..........#####.#.##...#..#....#.#..#.#.#####.###....####.##.####....###.#####.#.#..#
.##......#...####.#######..####..#..#..##.###.###.##.##.##...##.###.####.##.####.##.####.###.##...##.##.#
...####..#.....##.#....#####.....#..##.##.#.#..##.##..##.#.....#...........#..#...........#.....#.##..##.
##.##.#..##..#....#..#.#.....###.#####.##.##.#.........#.##..#.#.##..##.##....##.##..##.#.#..##.#........
......##.####.########.#..####.#.#..##..##.######.##.#.######..#.####.#.#.##.#.#.####.#..######.#.##.####
#..#####....###..##...###.....##.#.......#...##.##.#..#.....#.##..#.##..#..#..##.#..##.#.....#..#.##.##..
##.#..######...#....#.#.###.#.#..##.##.#.##....#.##.#..######.#.#.##.#..##..#.##.#.#.######..#.##.#....##
##.##..##..###...##...###.###.#.#.#..#..#.####..#.#..#.##..##.##...##########...##.##..##.#..#.#..####.#.
#...#....#..#.###.####.......##..###..#.....#.#...##.....#..##.#.....#..#.....#.##..#.....##...#.#.....#.
#...#..#....#...###..#.##..#..##.#####.##...#.#######.##.....#.##..#....#..##.#.....##.#######.#...##.###
##.####.##..####.....#.######.....##.#####..#..#..#.#.#.##.#.#.####.##.####.#.#.##.#.#.#..#..#..#####.##.
.#.##.#..####...###.##..#..#.####...#....###.#..#.##..#.##..##.#..####..#.##..##.#..##.#..#.###....#...##
#....###.#...##..##.#.#.#..##.....#...##.#.####.##.#..#...#.##.#.#..#.#.##.#...#..#.##.####.#.##...#.....
####.###.#.#.#.#..#.##..#.#.#..##.######.##..#...#.###.####...##.##.##...####.###.#...#..##.######.##..#.
......#..##..####.##.#..#..####.#..#..#...#..#.#.#.#.##.....#.##..##.#.....##.#.#.#.#..#...#..#..#.####..
.##.#.#.#.##...#...#.###.#..#.##.#..#.#...##.#..##....#..##..........##..#....##..#.##...#.#..#.##.#..#.#
#.#.###..#.##..#.#.###.####.##.####.####.#.#..#.####.########.##.########.####.#..#.#.####.####.##.####.#
##....##..#.#.##..#..#...#....#..#.....#..####...###.....##.#..#.##.....###...####..#.....#..#....#...#..
.#.##...#..##.#.#..#.##..#.##....#.###..#.##.#....#####.....##.....#####....#.##.#..###.#....##.#..##.#..
##.#.##.##.#..#.##..#.#..#.#.#####.######...#####..##.#.########.#.##..#####...######.#####.#.#..#.#..##.
...##.#.#..#.##...#...###..##.......#.....#.##..#.....#..#..#..#.....#..##.#.....#.......##..###...#...##
#...##..##.#.#.##..####.##..#..##...#..##.#.....##.###.#.##.#.###.##.....#.##..#...##..#..##.####..##.#.#
##.#.#...#...#####.#.....######.##.####.#.#.##.#.###.###..###.###.#.##.#.#.####.##.######.....#.#####...#
##.####.###....###.#.##.#..#..####..#.##..##.#..#..#........#..#..#.##..##.#..####..#..#.##.#.###....###.
#....##.#.###...#..#.##..#.#.#..###.##.#...#..#....##.##.##....#..#...#.##.###..#.#.#..##.#..#...###.#.##
#..#.##.###.###.#.##.#.#..##.##..#...####.###.###.#.####.#.###.###.####...#..##.##..#.#.##.#.###.###.##.#
####..##......###.#..##.#.##..#..#.....##.#.#..##..#..#..##..#.#.##.....#..#..##.#.##..#.###......##..###
.......#.##....##.#.#.#.......#..##..#....##.#..##....##..#.##....#..##..#.......#.#.#.##....##.#.......#
#.##.#.#.###.#...##..####.##..##.####.####.####.#.##.#.####.####.####.##..##.####..##...#.###.#.#.##.##.#
#..#..##.#.#...#..##.##.#.######....###...#..#..#..#.S#..#...###....######.#.##.##..#...#.#.##..#..#.#..#
##..#.#..##.#####......##..#..######...##....#..##..#....##...######..#..##......#####.##..#.#..##...#...
#####.#.#.#.#..#.##.##.#.#.##..##..###.#.##############.#.###..##..##.#.#.##.##.#..#.#.#.#.#########.##.#
#....##...#.#..##.#.#..##...#....#..#..##....#..#....##..#..#....#...##..#.#.##..#.#...##....#..#..####.#
#..#..####..##..##..##..#...#..#....##..#..#....#..#..##....#..#...#..##..##..##..####..#..#....#.#...#.#
#####..#.#...###.#...#####.####.##...######....######...##.####.#####...#.###...#.#..######.##.##..##.##.
...#.#...##.#..####.#....#.##.#..##.#..#........#..#.##..#.##.#....#.####..#.##...#.#.....####...#.#.....
#..#####.##..#...##..####....###.##..#.#......#.#..##.###....####..##...#..##.#####..###.#..#.##...#.####
###..###..##...#.###.##.####.###.#.#..#......#..#.#.###.####.##.###.#...##..###..###.###.##.#####.##.##.#
......###...####..#...........#..#..#........#..#..#...........#..####...###......#...##..##..###........
.####..#.##.......##.##..##.#.#.###..........###.#.#.##..##.##.......##.#..####...##........#..#.###.##..
##..#..##.##..##.#.#.####.#.###.###........###.###.#.####.#.#.##..##.##..#..####.#.##.##.##.#..###.#.####
....#.#.#####..#..##.#..##....#..#........#..#....##..#.##..#..#####.#.#.......#..#.##.#.#..##....##.##.#
##.##..#..#.##..#.##.#.#.#.##.#............#.##.#.#.#.##.#..##.#..#..##.##.###..#....#...#...##.#.#....#.
.#.#.#.##.#######...##.###.#..#..........#..#.###.##...#######.##.#.#.#..#.########.#######.#.###.#..#.##
#..##...##..#.....#.##.....#..............#.....##.#.....#..##...##..###....#....##.#....##......####....
##..#.......#..##.#....##..##..........##..##....#.##..#.......#..##.#####..#..#..#.#..#.####..#....#..##
.#####..#######.#.#.########..........########.#.#.#######..#####.....##.########.######..##############.
#..#.####.....##..#....##..............##....#..##.....####.#..#.##.#...#......#...#........#..##..#.....
.#.#.#....####.#..##......................##..#.####....#.#.#..##.#.#.#...###..#.#.#..##..#.#....#.#..##.
..##.######...##########............##########...######.##..#.#.##..#.#####.#.##..###..###..####..###..#.
#.##...#....#.##..#....................#..##.#....#...##.#..#..#.#..#..#...##.#.#.#.##.#.#......#.#.##...
.....#.#####...##.#..#............#..#.##...#####.#......###.#.#####.#..##.#..#.#.####...##..##...######.
#.####..##.#....#####............#####....#.##..####.#####.###...#.####.#..#.##.##..####.####.####..#..#.
##.......#.##.....#..............#.....##.#.......##.##..#.....#..#..#..##.#.#...#...###....###...#.#.##.
.#..##.#.#.###..#................#..###.#.#.##..#......#.##.#####....#...#...#...#....######....#..##.##.
###.##..##.#.###................###.#.##..##.###.###.#..#.##...#.######.###..##.#####..##..#####.#......#
#.#...#.##.###.#..............#.###.##.#...#.#.###.#..#....#...##....##.#.#####.##..#....#..##.######.#..
##.##.....#..#................#..#.....##.##.#....####.##.####..#..#....###...#.....#..#.....#...##.#.##.
.######.#..#.#..............#.#..#.######.##.##.#.##.####.#..######.####...##.#.##.####.##.#.##.....#.#.#
...##.#..#..#..............#..#..#.##.......#.###...#.....#.#..#..###..#.#.#..#..#.##.#..#..#.#.####..#.#
#.....##..#................#..##.....####.#.......#...#####..#.###.....#...#..###....###..#...#.##.#..#.#
##########................##########.##.#####..##.#####....#..#..####.###.#####.####.#####.###...#.###...
...#..#....................#..#........#..#####.#..#....##..#..#...##.#.#.##..........##.#.#.#.#.#.#.#...
.#.##.#..................#.##.#..##.##......#.##.#..#######.##...#..#.##...#.##..##.#...##.#.#..##...##..
##...##................##...#####.#.#.##.##.##.####.##..###...#####..#.#.#.#.####.#.#.#.#..#..#.#########
...#....................#....##.##..#..#.#...#...#...##..#.####..#.#.#.#..##..#.##..#.#.#.####...##......
#####................#####.....#.#..##...#.#.##..#.#..#..###.....###.#..#.#.#.##.#..#.###.##.#.....####..
#..#................#..#.##..#.#.######..#..#.####....##.....###....#####.##...#####....#...######.##.#.#
#....................#.######..#.#..#.##..#.......##...#..####.##.#.#...##.#.....#.#.##...#.##........#..
#..................#..#.....#.##.#..#####.###..###.##.###.....#.##..#....#.##..#..##.#.##.#....###.###.##
..................#.#..######.#..#.#..#.#..####..####.#.###.#..#.#####.#.#.######.#..##.#.#.####.###.##..
..................#..#.##..##.#.##.##.##.#....#.#.....###.####..#....#..##.....#..###.##..##....#..#..#..
..................##.....#..###.#...##.#####.##...####........#...##..#.####...#....##.#...#..#....#####.
...............#######.#......#.#.....#..###..#####..####..##.########...#####.##....####.###.###.#..###.
...............#..#..#..##.##.####..#.....###..#...#..#####.#..#..##.#....#..#.###.....##.#.#..##.....#..
.............#..#.#.###.##.#.....###.####..#.#..##......#.##.#.##...#####.#.##.#.##..#....##.#..###...##.
............###.###.###....#.#####.###..#..####.#.##.##.##.###....#.##..###.##.#.####.####.####.####.#.##
.............#....#..#.##..#.##..#......#.#..#..#..#.#.........##.#...........##....###...#..#.....#..#.#
.............#.##.#..##.###....#.##.##.##.#..#..##...#..##..###.#.#.##..##..#.######...##....#.###..#..#.
..........####.#..##..###.##.#..#.##.#.#..##.#######.######.#.##..##.######.#..##..###.#.#####.#######...
.........#.....#...#.#.....#..#....#...#.#.#.#..#..###..###.##.#...#.#..###.#....#..#..##.......#.....###
